NO ./textures/wall.xpm
EA ./textures/wall.xpm
SO ./textures/wall.xpm
WE ./textures/wll.xpm

C 30,100,160
F 20,100,10

   11111111111111111
11100000001000000111
111000000010001111111
101100000110001 10001
100100000110001110001
111111111010010N0111
100000000010000001111
111111111111111111111