NO ./path_to_the_north_texture.xpm
EA ./path_to_the_east_texture.xpm
SO ./path_to_the_south_texture.xpm
WE ./path_to_the_west_texture.xpm

C 20,20,100
F 20,80,10

   11111111111111111
111000000010000001111111
1011000001100000000000001
1001000001100000000000001
1111111110100100011100001
1000000000100000011101111
11111111100001111111011111
   100010001001011111
111101111000000111011111
11000000110N001110000001
1000000000000000000010001
100000000000100000101001
1100000111010101101111111
  11011111101011011110101
 111111111111111111111111