NO ./bonus/textures/wall_bonus.xpm
EA ./bonus/textures/wall_bonus.xpm
SO ./bonus/textures/wall_bonus.xpm
WE ./bonus/textures/wall_bonus.xpm
DO ./bonus/textures/Ge.xpm

C 30,100,160
F 20,100,10

   11111111111111111
11100000001000000111
1110000000D0001111111
101100000110001 10001
100100000110001110001
111111111010010N0111
100000000010000011111
111111111111111111111